...####.......
####..#####...
#..#..#...####
#.xx.x#.#x#..#
#..#......x..#
##.#####.##..#
##.....o.o#x##
#..#x#xooo#..#
#....#.ooo...#
###..###.@#..#
..####.#######
..####.#######