###########
#...#...###
#...x.x...#
##.##o#...#
#@x##o##x##
#.xooooo..#
##x##o##x.#
#..##o#...#
#..x.x#..##
#.....#..#.
##########.
##########.