###################
#####...###########
#####x..###########
#####..x###########
###..x.x.##########
###.#.##.##########
#...#.##.#####..oo#
#.x..x..........oo#
#####.###.#@##..oo#
#####.....#########
###################
###################