#########################
#@....x...............o.#
#...................ox..#
#########################
#########################