#######
#..@..#
#ox.xo#
#ox.xo#
#oxoxo#
#oxxxo#
#ox.xo#
#.....#
#######
#######