#############
#...........#
#.x.........#
#.x.#.o.#.#.#
#.x.#.o##.#.#
#.x.#.o#....#
#.x.#.o#....#
#.x.#####ooo#
#.x.#...#####
#.x.#.oo#...#
#.x.#.oo#.x.#
#.x.#...#xx.#
#.x.....#oo.#
#........o@.#
#############
#############