#####################
#######..############
#####.x......xo.x.###
#####o........#.#.###
#...ooo#####.#.o#.###
#.x#x###.x.ox..x#.###
#.o#.#..xo...xo.#.###
##x#.#.##########.###
##o#..@..#..o.....###
######.#.#.x#...o####
##.....#.o.x.....####
##.#x###..#####.#o###
##.#..o#....###.x.###
##.#.x##..x..x....#o#
##.#oxo###.########x#
##..........o.......#
#####################
#####################