...#######   
####.....#
#...o###.#
#.#.#....##
#.#.x.x#o.#
#.#..#..#.#
#.o#x.x.#.#
##....#.#.###
.#.###o....@#
.#.....##...#
.############
.############